[header]
width=32
height=32

[layer]
type=background
data=
98,98,98,98,98,98,98,98,98,98,98,98,98,98,98,98,98,98,98,98,98,98,98,98,98,98,98,98,98,98,98,98,
98,98,98,98,98,98,98,98,98,98,98,98,98,98,98,98,98,98,98,98,98,98,98,98,98,98,98,98,98,98,98,98,
98,98,98,98,98,98,98,98,98,98,98,98,98,98,98,98,98,98,98,98,98,98,98,98,98,98,98,98,98,98,98,98,
98,98,98,98,98,98,98,98,98,98,98,98,98,98,98,98,98,98,98,98,98,98,98,98,98,98,98,98,98,98,98,98,
98,98,98,98,98,98,98,98,98,98,98,98,98,98,98,98,98,98,98,98,98,98,98,98,98,98,98,98,98,98,98,98,
98,98,98,98,98,98,98,98,98,98,98,98,98,98,98,98,98,98,98,98,98,98,98,98,98,98,98,98,98,98,98,98,
98,98,98,98,98,98,98,98,98,98,98,98,98,98,98,98,98,98,98,98,98,98,98,98,98,98,98,98,98,98,98,98,
98,98,98,98,98,98,98,98,98,98,98,98,98,98,98,98,98,98,98,98,98,98,98,98,98,98,98,98,98,98,98,98,
98,98,98,98,98,98,98,98,98,98,98,98,98,98,98,98,98,98,98,98,98,98,98,98,98,98,98,98,98,98,98,98,
98,98,98,98,98,98,98,98,98,98,98,98,98,98,98,98,98,98,98,98,98,98,98,98,98,98,98,98,98,98,98,98,
98,98,98,98,98,98,98,98,98,98,98,98,98,98,98,98,98,98,98,98,98,98,98,98,98,98,98,98,98,98,98,98,
98,98,98,98,98,98,98,98,98,98,98,98,98,98,98,98,98,98,98,98,98,98,98,98,98,98,98,98,98,98,98,98,
98,98,98,98,98,98,98,98,98,98,98,98,46,46,46,46,46,46,98,98,98,98,98,98,98,98,98,98,98,98,98,98,
98,98,98,98,98,98,98,98,98,98,46,46,46,46,46,46,46,46,46,46,98,98,98,98,98,98,98,98,98,98,98,98,
98,98,98,98,98,98,98,98,98,46,46,46,46,46,46,46,46,46,46,46,46,98,98,98,98,98,98,98,98,98,98,98,
98,98,98,98,98,98,98,98,98,46,46,46,46,46,46,46,46,46,46,46,46,98,98,98,98,98,98,98,98,98,98,98,
98,98,98,98,98,98,98,98,98,46,46,46,46,46,46,46,46,46,46,46,46,98,98,98,98,98,98,98,98,98,98,98,
98,98,98,98,98,98,98,98,98,98,46,46,46,46,46,46,46,46,46,46,98,98,98,98,98,98,98,98,98,98,98,98,
98,98,98,98,98,98,98,98,98,98,98,98,46,46,46,46,46,46,98,98,98,98,98,98,98,98,98,98,98,98,98,98,
98,98,98,98,98,98,98,98,98,98,98,98,98,46,46,46,46,98,98,98,98,98,98,98,98,98,98,98,98,98,98,98,
98,98,98,98,98,98,98,98,98,98,98,98,98,46,46,46,46,98,98,98,98,98,98,98,98,98,98,98,98,98,98,98,
98,98,98,98,98,98,98,98,98,98,98,98,98,46,46,46,46,98,98,98,98,98,98,98,98,98,98,98,98,98,98,98,
98,98,98,98,98,98,98,98,98,98,98,98,98,46,46,46,46,98,98,98,98,98,98,98,98,98,98,98,98,98,98,98,
98,98,98,98,98,98,98,98,98,98,98,98,98,46,46,46,46,98,98,98,98,98,98,98,98,98,98,98,98,98,98,98,
98,98,98,98,98,98,98,98,98,98,98,98,46,46,46,46,98,98,98,98,98,98,98,98,98,98,98,98,98,98,98,98,
98,98,98,98,98,98,98,98,98,98,98,98,46,46,46,46,98,98,98,98,98,98,98,98,98,98,98,98,98,98,98,98,
98,98,98,98,98,98,98,98,98,98,98,98,46,46,46,46,98,98,98,98,98,98,98,98,98,98,98,98,98,98,98,98,
98,98,98,98,98,98,98,98,98,98,98,98,46,46,46,46,98,98,98,98,98,98,98,98,98,98,98,98,98,98,98,98,
98,98,98,98,98,98,98,98,98,98,98,98,46,46,46,46,98,98,98,98,98,98,98,98,98,98,98,98,98,98,98,98,
98,98,98,98,98,98,98,98,98,98,98,98,46,46,46,46,98,98,98,98,98,98,98,98,98,98,98,98,98,98,98,98,
98,98,98,98,98,98,98,98,98,98,98,98,46,46,46,46,98,98,98,98,98,98,98,98,98,98,98,98,98,98,98,98,
98,98,98,98,98,98,98,98,98,98,98,98,46,46,46,46,98,98,98,98,98,98,98,98,98,98,98,98,98,98,98,98

[layer]
type=object
data=
923,924,925,923,924,925,923,924,925,923,924,925,923,924,925,923,924,925,923,924,925,923,924,925,923,924,925,923,924,925,923,924,
923,924,925,923,924,925,923,924,925,923,924,925,923,924,925,923,924,925,923,924,925,923,924,925,923,924,925,923,924,925,923,924,
923,924,925,923,924,925,923,924,925,923,924,925,923,924,925,923,924,925,923,924,925,923,924,925,923,924,925,923,924,925,923,924,
923,924,925,923,924,925,923,924,925,923,924,925,923,924,925,923,924,925,923,924,925,923,924,925,923,924,925,923,924,925,923,924,
923,924,925,923,924,925,923,924,925,923,924,925,923,924,925,923,924,925,923,924,925,923,924,925,923,924,925,923,924,925,923,924,
923,924,925,923,924,925,923,924,925,923,924,925,923,924,925,923,924,925,923,924,925,923,924,925,923,924,925,923,924,925,923,924,
923,924,925,923,924,925,923,924,925,923,924,925,923,924,925,923,924,925,923,924,925,923,924,925,923,924,925,923,924,925,923,924,
923,924,925,923,924,925,923,924,925,923,924,925,923,924,925,923,924,925,923,924,925,923,924,925,923,924,925,923,924,925,923,924,
923,924,925,923,924,925,923,924,925,923,924,925,923,924,925,923,924,925,923,924,925,923,924,925,923,924,925,923,924,925,923,924,
923,924,925,923,924,925,923,924,925,923,924,925,923,924,925,923,924,925,923,924,925,923,924,925,923,924,925,923,924,925,923,924,
923,924,925,923,924,925,923,924,925,923,924,925,923,924,925,923,924,925,923,924,925,923,924,925,923,924,925,923,924,925,923,924,
923,924,925,923,924,925,923,924,925,0,0,17,125,125,125,125,125,125,18,0,0,923,924,925,923,924,925,923,924,925,923,924,
923,924,925,923,924,925,923,924,925,17,125,126,0,907,908,908,909,0,124,125,18,923,924,925,923,924,925,923,924,925,923,924,
923,924,925,923,924,925,0,0,17,126,0,0,0,899,920,921,901,0,0,0,124,18,0,0,923,924,925,923,924,925,923,924,
923,924,925,923,924,925,0,0,99,0,0,0,0,0,0,0,0,0,0,0,0,97,0,0,923,924,925,923,924,925,923,924,
923,924,925,923,924,925,0,0,99,0,0,0,0,0,194,0,0,0,0,0,0,97,0,0,923,924,925,923,924,925,923,924,
923,924,925,923,924,925,0,0,99,0,0,0,0,0,221,0,0,0,0,0,0,97,0,0,923,924,925,923,924,925,923,924,
923,924,925,923,924,925,0,0,44,72,0,0,0,0,0,0,0,0,0,0,70,45,0,0,923,924,925,923,924,925,923,924,
923,924,925,923,924,925,923,924,925,44,71,72,0,0,0,0,0,0,70,71,45,923,924,925,923,924,925,923,924,925,923,924,
923,924,925,923,924,925,923,924,925,0,0,44,72,0,0,0,0,70,45,0,0,923,924,925,923,924,925,923,924,925,923,924,
923,924,925,923,924,925,923,924,925,923,924,925,99,0,0,0,0,97,923,924,925,923,924,925,923,924,925,923,924,925,923,924,
923,924,925,923,924,925,923,924,925,923,924,925,99,0,0,0,0,97,923,924,925,923,924,925,923,924,925,923,924,925,923,924,
923,924,925,923,924,925,923,924,925,923,924,925,99,0,0,0,0,97,923,924,925,923,924,925,923,924,925,923,924,925,923,924,
923,924,925,923,924,925,923,924,925,0,0,17,126,0,0,0,0,97,923,924,925,923,924,925,923,924,925,923,924,925,923,924,
923,924,925,923,924,925,923,924,925,0,0,99,0,0,0,0,70,45,923,924,925,923,924,925,923,924,925,923,924,925,923,924,
923,924,925,923,924,925,923,924,925,0,0,99,0,0,0,0,97,0,923,924,925,923,924,925,923,924,925,923,924,925,923,924,
923,924,925,923,924,925,923,924,925,0,0,99,0,0,0,0,97,0,923,924,925,923,924,925,923,924,925,923,924,925,923,924,
923,924,925,923,924,925,923,924,925,0,0,99,0,0,0,0,97,0,923,924,925,923,924,925,923,924,925,923,924,925,923,924,
923,924,925,923,924,925,923,924,925,0,0,99,0,0,0,0,97,0,923,924,925,923,924,925,923,924,925,923,924,925,923,924,
923,924,925,923,924,925,923,924,925,0,0,99,0,0,0,0,97,0,923,924,925,923,924,925,923,924,925,923,924,925,923,924,
923,924,925,923,924,925,923,924,925,0,0,99,0,0,0,0,97,0,923,924,925,923,924,925,923,924,925,923,924,925,923,924,
923,924,925,923,924,925,923,924,925,0,0,99,0,0,0,0,97,0,923,924,925,923,924,925,923,924,925,923,924,925,923,924

[layer]
type=collision
data=
0,0,0,0,0,0,0,0,0,0,0,0,0,0,0,0,0,0,0,0,0,0,0,0,0,0,0,0,0,0,0,0,
0,0,0,0,0,0,0,0,0,0,0,0,0,0,0,0,0,0,0,0,0,0,0,0,0,0,0,0,0,0,0,0,
0,0,0,0,0,0,0,0,0,0,0,0,0,0,0,0,0,0,0,0,0,0,0,0,0,0,0,0,0,0,0,0,
0,0,0,0,0,0,0,0,0,0,0,0,0,0,0,0,0,0,0,0,0,0,0,0,0,0,0,0,0,0,0,0,
0,0,0,0,0,0,0,0,0,0,0,0,0,0,0,0,0,0,0,0,0,0,0,0,0,0,0,0,0,0,0,0,
0,0,0,0,0,0,0,0,0,0,0,0,0,0,0,0,0,0,0,0,0,0,0,0,0,0,0,0,0,0,0,0,
0,0,0,0,0,0,0,0,0,0,0,0,0,0,0,0,0,0,0,0,0,0,0,0,0,0,0,0,0,0,0,0,
0,0,0,0,0,0,0,0,0,0,0,0,0,0,0,0,0,0,0,0,0,0,0,0,0,0,0,0,0,0,0,0,
0,0,0,0,0,0,0,0,0,0,0,0,0,0,0,0,0,0,0,0,0,0,0,0,0,0,0,0,0,0,0,0,
0,0,0,0,0,0,0,0,0,0,0,0,0,0,0,0,0,0,0,0,0,0,0,0,0,0,0,0,0,0,0,0,
0,0,0,0,0,0,0,0,1,1,1,1,1,1,1,1,1,1,1,1,1,1,0,0,0,0,0,0,0,0,0,0,
0,0,0,0,0,0,0,0,1,0,0,0,0,1,1,1,1,0,0,0,0,1,0,0,0,0,0,0,0,0,0,0,
0,0,0,0,0,1,1,1,1,0,0,0,0,1,0,0,1,0,0,0,0,1,1,1,1,0,0,0,0,0,0,0,
0,0,0,0,0,1,0,0,0,0,0,0,0,1,0,0,1,0,0,0,0,0,0,0,1,0,0,0,0,0,0,0,
0,0,0,0,0,1,0,0,0,0,0,0,0,0,0,0,0,0,0,0,0,0,0,0,1,0,0,0,0,0,0,0,
0,0,0,0,0,1,0,0,0,0,0,0,0,0,1,0,0,0,0,0,0,0,0,0,1,0,0,0,0,0,0,0,
0,0,0,0,0,1,0,0,0,0,0,0,0,0,1,0,0,0,0,0,0,0,0,0,1,0,0,0,0,0,0,0,
0,0,0,0,0,1,0,0,0,0,0,0,0,0,0,0,0,0,0,0,0,0,0,0,1,0,0,0,0,0,0,0,
0,0,0,0,0,1,1,1,1,0,0,0,0,0,0,0,0,0,0,0,0,1,1,1,1,0,0,0,0,0,0,0,
0,0,0,0,0,0,0,0,1,0,0,0,0,0,0,0,0,0,1,1,1,1,0,0,0,0,0,0,0,0,0,0,
0,0,0,0,0,0,0,0,1,1,1,1,0,0,0,0,0,0,1,0,0,0,0,0,0,0,0,0,0,0,0,0,
0,0,0,0,0,0,0,0,0,0,0,1,0,0,0,0,0,0,1,0,0,0,0,0,0,0,0,0,0,0,0,0,
0,0,0,0,0,0,0,0,1,1,1,1,0,0,0,0,0,0,1,0,0,0,0,0,0,0,0,0,0,0,0,0,
0,0,0,0,0,0,0,0,1,0,0,0,0,0,0,0,0,0,1,0,0,0,0,0,0,0,0,0,0,0,0,0,
0,0,0,0,0,0,0,0,1,0,0,0,0,0,0,0,0,0,1,0,0,0,0,0,0,0,0,0,0,0,0,0,
0,0,0,0,0,0,0,0,1,0,0,0,0,0,0,0,0,0,1,0,0,0,0,0,0,0,0,0,0,0,0,0,
0,0,0,0,0,0,0,0,1,0,0,0,0,0,0,0,0,0,1,0,0,0,0,0,0,0,0,0,0,0,0,0,
0,0,0,0,0,0,0,0,1,0,0,0,0,0,0,0,0,0,1,0,0,0,0,0,0,0,0,0,0,0,0,0,
0,0,0,0,0,0,0,0,1,0,0,0,0,0,0,0,0,0,1,0,0,0,0,0,0,0,0,0,0,0,0,0,
0,0,0,0,0,0,0,0,1,0,0,0,0,0,0,0,0,0,1,0,0,0,0,0,0,0,0,0,0,0,0,0,
0,0,0,0,0,0,0,0,1,0,0,0,0,0,0,0,0,0,1,0,0,0,0,0,0,0,0,0,0,0,0,0,
0,0,0,0,0,0,0,0,1,0,0,0,0,0,0,0,0,0,1,0,0,0,0,0,0,0,0,0,0,0,0,0

[event]
# Teleport to Laurelia
type=teleport
location=11,31,6,1
intermap=laurelia.txt,91,2

[event]
# Fairy Flower
type=run_once
requires_not=flowerfound
requires_status=elderintro
location=14,15,1,2
hotspot=-16,-16,32,64
loot=id,14,16,199
tooltip=Fairy Flower

[event]
# Teleport to Cavern
type=teleport
requires_status=cavernexplored
location=14,12,2,2
intermap=cavern.txt,61,36

